xxxxxxxxxxxxxxxxxxxxx
x0000000000000000000x
x0000xx0000000000000x
x0000000000x00000000x
x00000000000000xx000x
x000000000x000000000x
x00000000xx000000000x
x0p00000xxx000000000x
xxxxxxxxxxxxxxxxxxxxx
